##
## ULTRAFRENCH DICTIONARY
##
## Lines starting with ‘#’ are ignored. Entries are automatically
## sorted alphabetically; they can be in any order in this file.
##
## Each line in this file is an entry in the dictionary. An entry
## consists of several fields, each delimited by ‘|’. No field may
## contain a ‘|’ character. The fields are as follows:
##
##     1. The word in the UF orthography.
##     2. The part of speech and other initial annotations.
##     3. The etymology of the word. If this field contains no spaces, it
##        is assumed to be a PF word.
##     4. The English translation of the word.
##     5. (optional) Grammatical forms of the word.
##
## To break an entry across multiple lines, end each line with a ‘\’
## character. There MUST NOT be any characters between the ‘\’ and the
## end of the line. The ‘\’ character will be removed and the next line
## will be concatenated to the current line.
##
## Furthermore, it is possible to create references to other entries by
## adding a line that contains NO ‘|’ characters and is of the form
##
##     entries > reference
##
## where ‘entries’ is a comma-separated list of words for which to create
## references, and ‘reference’ is the word to which the references should
## point.
##

ad’hór|v. tr.|adore|1. To love, adore.\
    2. +\s{part} To be in love with, have a crush on.\
    3. +\s{gen} To desire (someone)|\s{fut} *ad’hórérẹ́*, \s{subj} *ad’hórs*

aub’heír|v. (in)tr.|obéir|To obey
ánvé|v. tr.|animer|To bring to life, animate
dír|v. tr.|dire|To say, tell|\s{fut} *dírẹ́*, \s{subj} *díss*
vvaúríhe|v. (in)tr.|mémoriser|To remember|\s{fut} *vvaúríźe*
y’ír|v. (in)tr.|ouïr|To hear, understand, listen
Cár|n.||*male given name, equivalent to English ‘Kyle’ or ‘Charles’*
ráhó|n.|poisson|Fish
act’he|v. tr.|\nf from *ac*|1. To cut or cleave with an axe. \
    2. +\s{acc} To bring an end to. \
    3. +\s{acc def} *of* ***árb*** *intr. (other than literal)* To get to the point, cut to the chase. \
    4. +\s{acc def} *of* ***árb*** *and* \s{acc} \
    To bring to light, reveal *(originally, this idiom did not take a double \s{acc}, but \
    was instead formed with the \s{acc} of ‘tree’ and the \s{ill} of the object, meaning something along \
    the lines of ‘to bring down the tree(s) on sth’—the image here being that of cutting down trees in \
    a wood until only a clearing remains or is ‘brought to light’)*|\s{fut} *acḍe*, \s{subj} *act’hes*
aċt’he|v. tr.|acheter|To buy|\s{fut} *aċḍrẹ́*, \s{subj} *aċt’hes*
vaût’há|n.|montagne|Mountain
ḍalẹ|n.|tableau|Table
ehyó|n.|écusson|Shield
rvá|interj.|of unknown origin|Alas, woe, oh. *Exclamation of distress, surprise, sadness, or regret*| \
    *after words that end with ‘r’, this is spelt ‘-vá’ instead*
ḅárḍáḍ|v.|partante| (+ \s{aci}) To be interested in, willing to, ready to, prepared for
c’hes|part.|\pfabbr qu'est-ce que|*interrogative particle*
Daúvníc’h|n.||*male or female given name, equivalent to English ‘Dominic’*
Já|n.||*male or female given name, equivalent to English ‘John’ or ‘Joan’*
ráy’é|v.|noyer|To drown
ráý’ẹ|v.|râler|To complain, grumble
ḍèr|v.|taire|To silence, shut up|\s{fut} *ḍérẹ́*
ḅáł|v.|parler|To speak, talk, say|\s{fut} *báłérẹ́*
ab’hásy’ô|n.|aviation|Aviation
rá|n.|loi|Law, rule, regulation
ḍẹ|adj.|tout|All, every, whole, entire
c’hóný|adj.|connu|Known, familiar, well-known
y’aúhý|inconj., postpos.|\pfabbr il n’y a aucun|There is no, there are no, there is none
ý’aúhý|inconj., postpos.|\pfabbr il y a aucun|There is, there are
ráy’ê|n.|moyen|1. Way, means, method. 2. *ráy’ê y’aúhý* + \s{aci} There is no way, that..
ub’hrá|v.|pouvoir|1. To be able to, can. 2. +\s{part} Capable of ..|\s{fut} *úrẹ́*, \s{subj} *ís*
ab’héy’|n.|abeille|Bee
b’hóy’ẹ|v.|voler|To fly. Flight
ez-|pron.|ses|Its, her, his, their
lýr|pron.|leur|Their
el|n.|ailles|Wing, blade, fin.
Lác|n.||*female given name, equivalent to English ‘Bi\-anca’*
auḍé|v.|obtenir|1. To obtain, get, acquire. 2. +\s{abl} To gain purchase on or height or distance from|\s{fut} *auḍy’édrẹ́*
sol|n.|sol|Ground, floor, earth, soil
c’hór|n.|corps|Body
c’hýr|n.|corps|Heart
ab’haḍ|v.|abattre|1. To cut down, fell, knock down, shoot down. 2. To butcher, cut apart violently|\s{fut} *ab’haḍrẹ́*, \s{subj} *ab’has*
árb|n.|arbre|Tree
ac|n.|hache|Axe, hatchet
asý’ýâ|particle|\pfabbr pas absolument|Not, no. *Commonly* ***’sý’ýâ*** *after vowels. This \
    particle is used only in the indicative; see also* ***sá****, ****t’hé***
c’hd’hal|adv.|\pfabbr que dalle|Naught, absolutely nothing
jávé|adv.|jamais|Never, at no time
ráv́â|adv.|rarement|Seldom, rarely (ever)
y’é|adv.|rien|Nothing
au|conj.|aussi|And, also, as well, too
eċ|n.|péché|Sin, transgression, wrongdoing
vaûd|n.|monde|World
ânb’hé|adv.|\pfabbr en effet\nf, via metathesis from \**âné\-b’he*|Verily, indeed, in fact
y’ŷ|prefix|mieux|*Affirming comparative prefix. See grammar*
lẹ|prefix|plus|*Denying comparative prefix. See grammar*
rê|prefix|moins|*Neutral comparative prefix. See grammar*
ré|prefix|très|*Superlative prefix. See grammar*
râdvâ|prefix|grandement|*Superlative prefix. See grammar*
nájẹ|v.|nager|To swim|\s{fut} náȷ́ẹ, \s{subj} nájes
e|n.|eau|Water
dẹhẹ|n.|dessus|1. Top, upper side. 2. Surface of a body of water
b’he|conj.|envers|+\s{subj} To, so as to, in order to, so that. *Commonly enclitic* \
    ***’b’h*** *after vowels*
ḅarḍ|v.|partir| To leave, go away, depart|\s{fut} *ḅarẹ́*, \s{subj} *ḅars*
ad’he|v.|vader|To go|\s{fut} *ad’hrẹ́*, \s{subj} *ad’hes*
sá|particle|sans|Not, no. *Always s’ before vowels. \
    This particle is used only in the subjunctive; see also* ***asý’ýâ****, ****t’hé***
s|conj.|si|If, when, whenever
c’haúr|conj.|\pfabbr car + comme|+\s{subj} As, because, since
y’ís|conj.|puisque|Considering that, since, because *(unlike* **c’haúr***, this does not take \
    the subjunctive; it is used to indicate the (potential) cause of something)*
laúrs|conj.|lorsque|When (temporal only)
áhaúr|conj.|encore|+\s{subj} Even though
ráhẹ|conj.|quoique|+\s{subj} Although, though
aý’aúr|conj.|alors|While, as (temporal)
ḍá|conj.|tandis|Whereas
de|conj.|\pfabbr dès que|+\s{subj} Once, when once, as soon as
sá|conj.|\pfabbr sans que|+\s{subj} Without (doing sth.)
sauc’h|conj.|\pfabbr sauf que|+\s{subj} Except that
váłé|conj.|\pfabbr malgré que|+\s{subj} Despite that, in spite of
rê|conj.|\pfabbr bien que|+\s{subj} Although, though
daúc’h|conj.|donc|+\s{subj} So, therefore, thus
ḅas|conj.|parce que|+\s{subj} Because *(often used to explain motivation rather than cause as in \
    ‘We did that because\ldots’)*
le|v.|\pfabbr laisser {\nf > \**lehe*}|*(chiefly in questions or imperative)* To let, allow, permit|\
    \s{fut} *lere*, \s{subj} *les*
auha|conj.|\pfabbr au cas où|+\s{opt} In case
ab’há|conj.|\pfabbr avant que|+\s{opt} Before
ḅré|conj.|\pfabbr après que|+\s{opt} After
t’hé|conj.|\pfabbr de peur que {\nf > \**dbhýrc’h* > \**dýrc’h* > \**dc’hý* > \**t’hé*}|Not, no. \
    *Always t’h’\N before vowels. \
    This particle is used only in the optative; see also* ***asý’ýâ****, ****sá***
jys|conj.|\pfabbr jusqu'à ce que|+\s{opt} Until
ávrê|conj.|\pfabbr à moins que|+\s{opt} Unless
úrbh|conj.|\pfabbr pour peu que|+\s{opt} Provided that, so long as
sit’há|conj.|\pfabbr si tant est que|+\s{opt} Supposing that; if, assuming that
fahaú|conj.|\pfabbr de façon que|+\s{opt} In such a way that
véhýr|conj.|\pfabbr dans la mesure où|Insofar as
sḅé|v.|espérer|+\s{opt} To wish, want, desire|\s{fut} *sḅérẹ́*, \s{subj} *sḅés*
rêd|v.|craindre|+s{opt} To fear, lest \ldots *(construed with the negated optative)*|\s{fut} \
    *rêdrẹ́*, \s{subj} *rês*



rá|v.|grand|Big, large, great
laú|v.|long|Long
lár|v.|large|Wide, broad
ebhẹ|v.|épais|To be thick|\s{fut} ebhrẹ, \s{subj} ebhes
lúr|v.|lourd|To be bulky, oversized, heavy
ḅẹt’hẹ|v.|petit|To be small, little
c’húr|v.|court|To shrink, reduce in size, narrow
eḍrrá|v.|étroit|Pointy
c’hánár|n.|canard|Ship, boat
ráhe|n.|oiseau|Bird
ráhé|n.|{\nf from} ráhe + ráhó|Flying fish
raúl|n.|parole|1. Language, speech, word 2. **Rául** *definite only* Short for *T’hebhaú Rául* *(\s{nom\
    sg} irreg.* **Rául***; all other forms are regular)*
rét’hẹ|v.|traiter|To handle, take care of, deal with|\s{fut} rét’hẹre, \s{subj} rét’hes


# From Étienne.
Eḍy’ê|n.||*male given name, equivalent to English ‘Ste\-phen’*

# Expressions.
lẹhuvud|n.|\pfabbr coup de foudre|Love at first sight
c’háraúciḍ|v.|\pfabbr les carrotes sont cuites|To end for good, put to a permanent end\
    |\s{fut} *c’háraúcre*, \s{subj} *c’háraúc*
ḅauheŷnlabhé|v.|\pfabbr poser un lapin|To forsake, abandon|\s{fut} *ḅauheŷnlabhére*, \s{subj} *ḅauheŷnlabhés*
férrrásvát’h|n.|\pfabbr fer la grasse matinée|A long, deep sleep
rác’hsaý’ad|v.|\pfabbr raconter des salades|To lie, tell tall tales, overexaggerate|\s{fut}\
    *rác’hsa\-ý’e*, \s{subj} *rác’hsaýs*
férḍufraú|v.|\pfabbr en faire tout un fromage|To make a big fuss about something|\s{fut}\
    *férḍu\-fraúrẹ́*, \s{subj} *férḍufraús*
daúb’hedwébhó|v.|\pfabbr tomber dans les pommes|To faint|\s{fut} *daúb’hedwébhóre*, \s{subj}\
    *daúb’hedwébhós*
rádrénẹ́|v. + \s{aci}|\pfabbr les doigts dans le nez|To put no effort into|\s{fut} *rádrénrẹ́*,\
    \s{subj} *rádrénẹ́s*
uy’ed’háb’hrí|v.|\pfabbr rouler dans la farine|To scam, swindle, cheat|\s{fut} *uy’e\-d’háv́e*,\
    \s{subj} *uy’ed’háb’hrís*
ab’hínéb’heḅaý’évrâ|v.|\pfabbr habit ne fait pas le moine|To judge based on appearances|\s{fut}\
    *ab’hínéb’heḅaý’év́ẹ́*, \s{subj} *ab’hínéb’heḅaý’év́ás*
rrád’hahánár|n.|\pfabbr froid de canard|Coldness
y’ŷvéłáfrí|n. pl. archaic|yeux de merlan frit|Eyes
y’ŷ|n.|{\nf from} y’ŷvéłáfrí|Eye
lârdávrá|n.|\pfabbr langue de bois|Evasive, unclear, or overly formal speech
urdálbhaúrḍ|n.|\pfabbr avoir un oursin dans le portefeuille|A very rich person; billionaire
vádłabhaud’hávúrsab’hád’háváb’hrárḍuẹ|v. literary|\pfabbr vendre la peau de ours avant de avoir tué|\
    To depend on predictions of the future *(of disputed origin; first attested in the \
    works of the Early UF comedian J. A. B. Smyth)*| \s{fut} *vádłabhaud’hávúrsab’hád’háváb’hrárḍure*,\
    \s{s} *vádłabhaud’hávúrsab’hád’háváb’hrárḍus*
râdrásôn|v.|\pfabbr prendre ses jambe à son cou|To run|\s{fut} *râdrásônre*, \s{subj} *râdrásôns*
t’hebhaúz|v.|\pfabbr jeter l’éponge|To be French| \s{fut} *t’hebhaúźe*, \s{subj} *t’hebhaúś*
T’hebhaú|n. or adj.|{\nf from} t’hebhaúz|France, French
T’hebhaú Rául|n. def. sg. (only {\nf T’hebhaú} is declined as though the entire phrase were one word)\
    |{\nf from} t’hebhaúz + rául|The Ultrafrench language *(in informal speech and writing, this is\
    typically shortened to* **Raúl***)*|\s{nom sg} *T’hebhaú Rául* *(regular in all other cases)*


# To be is a rather complicated entry.
eḍ|v. irreg. |être|To be|*active only*.                                  \
    \s{\textbf{pres:} sg} *vy’í*, *ḍe*, *le*, *lle*, *s*;                \
    \s{pl} *aúsó*, *b’heḍ*, *lẹsó*, *llẹsó*, *lasó*;                     \
    \s{inf} *éḍ*.                                                        \
    \s{\textbf{pres ant:} sg} *vẹ*, *ḍyf*, *leb’h*, *lleb’h*, *seb’h*;   \
    \s{pl} *aúfý*, *b’hu*, *lẹfýr*, *llẹfýr*, *lafýr*;                   \
    \s{inf} *éfyḍ*.                                                      \
    \s{\textbf{pret:} sg} *vet’h*, *ḍet’h*, *let’h*, *llet’h*, *set’h*;  \
    \s{pl} *weḍy’ó*, *b’heḍy’é*, *let’he*, *llet’he*, *laet’h*;          \
    \s{inf} *ét’hẹd*



s’ > sá

’sý’ýâ > asý’ýâ

úrẹ́, ís > ub’hrá

vá > rvá

vy’í, ḍe, le, lle, s, aúsó, b’heḍ, lẹsó, llẹsó, lasó, éḍ, \
    vẹ, ḍyf, leb’h, lleb’h, seb’h, aúfý, b’hu, lẹfýr, llẹfýr, lafýr, éfyḍ, \
    vet’h, ḍet’h, let’h, llet’h, set’h, weḍy’ó, b’heḍy’é, let’he, llet’he, laet’h, ét’hẹd > eḍ